%%%%%%%%%%%%%%%%%%%%%%%%%%%%%%%%%%%%%%%%%%%%%
%...........................................%
%%%%%%%%%%%%%..................%%%%%%%%%%%%%%
%...........................................%
%%%%..............%%%%%%%%%%%%%%%%%%%%%%%%%%%
%...........................................%
%%%%%%%%%%%%%%%%%%%%%%%%%%................%%%
%...........................................%
%%.........%%%%%%%%%%%%%%%%%%%%%%%%%%%%%%%%%%
%...........................................%
%%%%%%%%%%%%%%..........%%%%%%%%%%%%%%%%%%%%%
%...........................................%
%%%%%%%%%%%%%%%%%%%%%%%%%%.............%%%%%%
%...........................................%
%%..........%%%%%%%%%%%%%%%%%%%%%%%%%%%%%%%%%
%...........................................%
%%%%%%%%%.......................%%%%%%%%%%%%%
%...........................................%
%%%%%%%%%%%%%%%%%%%%%%%%%..............%%%%%%
%..........................................P%
%%%%%%%%%%%%%%%%%%%%%%%%%%%%%%%%%%%%%%%%%%%%%